###############################################
# #  # #      #   # # # # #   #   #   #   #   #
## ## ##.**** # * ######### #   #   # # # #   #
# #  # #    * #   #       #############   #   #
## ## ##### * ##### ***** #           #####   #
# #  # #  # * #     *   *   $**.*.**$     #####
##    ## ## * # ***** # *****  *#*  ***** #   #
##    ### # * # *   *   *   $**.*.**$   * # * #
# #  # # ## * # * # ***** #           # * #   #
## ## ### # *   * #       ############# * #####
# #  # # ## ***** ##########          # *   # #
## ## ##  #       #  #  #  #  *** *** # *** ###
# #  # # #################### * * * * #   * # #
##########                  # * * * * ### * ###
## #       #* * *#* * *#* # # * * * * ##  *  ##
# ## ******* *#* * *#* * ** # * * * * #  ***  #
## # *                ### *   * * * *   #   * #
# ## * ################ # ***#* *** ***** * * #
###  *  ## # # # # # #  #               #   * #
##  ***  ##############################  ***  #
#  #   #  ##           #### # # # # # ##     ##
# * * * *    #********    #####################
# *  #  *****    *    *** #           # # # # #
# * * * *   ***** ***** * # ****#**** ##     ##
#  #   #  #             *   #          ##     #
##  ***  ############## ********#****$ #     ##
###     ##  #  #  #   #             * @##     #
# #######         # * ##### *#*****#* ##     ##
# # # # # # # # # #   # # #           # # # # #
###############################################